4       0       3
2       0       3
3       0       2
5       0       1
1       0       1
0       1       2
0       3       3
0       4       3
0       5       4
0       5       1
2       3       0
3       3       0
4       3       0
6       2       0
3       2       0
